1111111111111
100100P000001
1000011111001
100011P000001
1111111111111
